NO textures/eagle.xpm
SO textures/greystone.xpm
WE textures/purplestone.xpm
EA textures/red.xpm

F 220,100,0
C 225,30,0


111111111111111111111111
100000001       10000001
100E000001       10000001
100000001       10000001
10000001       10000001       
10000001       10000001
10000011111111110000001
10000000000000000111111
 11111111111111111